#########
#E ######
##      #
## ## # #
##### # #
#>    ###
##### ###
##### ###
##### ###
##### ###
##### ###
##### ###
######### 
